#............................................................................................................# *  
#............................................................................................................# 
#............................................................................................................# 
#............................................................................................................# 
#............................................................................................................# 
#............................................................................................................# 
#............................................................................................................# 
#............................................................................................................# 
#............................................................................................................# 
#............................................................................................................# 
#............................................................................................................# 
#............................................................................................................# 
#.P..........................................................................................................# 
#@@@......................................................................................................@@@# 
####@@@@..............................................................................................@@@@#### 
########@@@@@@...................................................................................@@@@@######## 
##############@@@@@@.......................................................................@@@@@@############# 
####################@@@@@@@.........................................................@@@@@@@################### 
###########################@@@@@@@@........................B................@@@@@@@@########################## 
###################################@@@@@@@@@@@@@@@@@@@@@@@@@@@@@@@@@@@@@@@@@################################## 
############################################################################################################## *
